RK,Player,Pos,Squad,Age,Born,90s,Tkl,TklW,Def_3rd,Mid_3rd,Att_3rd,Tkl1,Att,Tkl%,Lost,Blocks,Sh,Pass,Int,Tkl+Int,Clr,Err
1,Che Adams,FW,Scotland,27,1996,2.3,2,1,1,1,0,1,1,100.0,0,2,0,2,1,3,0,0
2,Michel Aebischer,DF,Switzerland,27,1997,5.3,4,3,2,2,0,1,11,9.1,10,3,1,2,2,6,7,0
3,Arlind Ajeti,DF,Albania,30,1993,3.0,1,0,0,1,0,1,3,33.3,2,5,4,1,6,7,13,0
4,Manuel Akanji,DF,Switzerland,28,1995,5.3,2,2,2,0,0,1,2,50.0,1,6,6,0,4,6,22,0
5,Samet Akaydın,DF,Türkiye,29,1994,3.7,8,4,8,0,0,6,8,75.0,2,5,5,0,7,15,16,0
6,Nathan Aké,DF,Netherlands,28,1995,5.2,7,5,7,0,0,4,7,57.1,3,4,3,1,6,13,14,0
7,Yunus Akgün,FW,Türkiye,23,2000,0.8,2,1,1,1,0,2,2,100.0,0,1,0,1,0,2,0,0
8,Kerem Aktürkoğlu,"FW,MF",Türkiye,25,1998,1.2,1,1,1,0,0,1,2,50.0,1,1,0,1,1,2,3,0
9,Trent Alexander-Arnold,"MF,DF",England,25,1998,1.5,1,0,1,0,0,0,1,0.0,1,4,2,2,2,3,3,1
10,Denis Alibec,FW,Romania,33,1991,0.3,0,0,0,0,0,0,0,,0,0,0,0,0,0,0,0
11,Barış Alper Yılmaz,FW,Türkiye,23,2000,5.0,5,0,0,3,2,1,3,33.3,2,1,0,1,0,5,1,0
12,Sandro Altunashvili,MF,Georgia,26,1997,0.6,0,0,0,0,0,0,0,,0,0,0,0,0,0,3,1
13,Zeki Amdouni,"MF,FW",Switzerland,23,2000,0.6,0,0,0,0,0,0,2,0.0,2,0,0,0,0,0,1,0
14,Joachim Andersen,DF,Denmark,27,1996,4.0,5,1,2,3,0,3,3,100.0,0,4,1,3,2,7,11,0
15,Robert Andrich,MF,Germany,29,1994,3.5,12,8,8,4,0,5,7,71.4,2,3,1,2,2,14,12,0
16,Waldemar Anton,DF,Germany,27,1996,0.4,0,0,0,0,0,0,0,,0,0,0,0,0,0,2,0
17,Stuart Armstrong,MF,Scotland,31,1992,0.2,1,0,1,0,0,0,0,,0,0,0,0,0,1,0,0
18,Marko Arnautović,FW,Austria,34,1989,3.1,2,1,0,1,1,1,1,100.0,0,1,0,1,0,2,2,0
19,Jasir Asani,FW,Albania,28,1995,2.3,3,1,3,0,0,1,7,14.3,6,1,0,1,4,7,4,0
20,Kristjan Asllani,MF,Albania,21,2002,3.0,1,1,1,0,0,0,2,0.0,2,0,0,0,3,4,6,0
21,Kaan Ayhan,"MF,DF",Türkiye,29,1994,4.0,6,3,3,2,1,4,10,40.0,6,5,0,5,2,8,17,0
22,Alex Baena,"MF,FW",Spain,22,2001,0.3,1,1,1,0,0,1,3,33.3,2,0,0,0,0,1,0,0
23,Alexander Bah,"DF,MF",Denmark,26,1997,3.1,4,4,2,1,1,4,8,50.0,4,1,0,1,5,9,5,0
24,Nedim Bajrami,"FW,MF",Albania,24,1999,2.7,3,1,2,1,0,0,2,0.0,2,1,0,1,0,3,1,0
25,Johan Bakayoko,"FW,DF",Belgium,20,2003,0.5,2,1,1,1,0,0,3,0.0,3,0,0,0,0,2,0,0
26,Jure Balkovec,DF,Slovenia,29,1994,1.3,6,3,2,3,1,2,5,40.0,3,2,0,2,2,8,8,0
27,Iván Balliu,DF,Albania,32,1992,1.0,0,0,0,0,0,0,0,,0,1,1,0,2,2,2,0
28,Nicușor Bancu,DF,Romania,31,1992,3.0,2,2,2,0,0,1,1,100.0,0,6,2,4,0,2,11,0
29,Antonín Barák,MF,Czechia,29,1994,0.5,1,1,0,0,1,0,1,0.0,1,0,0,0,0,1,0,0
30,Bradley Barcola,"FW,MF",France,21,2002,1.1,4,4,1,1,2,1,4,25.0,3,6,0,6,0,4,0,0
31,Abdülkerim Bardakcı,DF,Türkiye,29,1994,4.0,4,2,4,0,0,3,6,50.0,3,5,3,2,2,6,20,0
32,Nicolò Barella,MF,Italy,26,1997,3.7,10,5,3,7,0,5,8,62.5,3,3,0,3,3,13,2,1
33,Alessandro Bastoni,DF,Italy,24,1999,4.0,5,2,2,3,0,2,3,66.7,1,4,2,2,1,6,17,0
34,Martin Baturina,FW,Croatia,20,2003,0.1,1,1,0,1,0,0,0,,0,0,0,0,0,1,0,0
35,Christoph Baumgartner,"MF,FW",Austria,24,1999,3.2,4,1,2,1,1,1,2,50.0,1,1,0,1,1,5,3,0
36,Altay Bayındır,GK,Türkiye,25,1998,1.0,0,0,0,0,0,0,0,,0,0,0,0,0,0,0,0
37,Jan Bednarek,DF,Poland,27,1996,3.0,2,1,2,0,0,2,6,33.3,4,8,7,1,3,5,13,0
38,Maximilian Beier,FW,Germany,21,2002,0.3,0,0,0,0,0,0,0,,0,0,0,0,0,0,0,0
39,Jude Bellingham,"MF,FW",England,20,2003,7.4,15,11,3,5,7,2,9,22.2,7,7,1,6,4,19,7,1
40,László Bénes,MF,Slovakia,26,1997,0.8,1,1,0,0,1,1,1,100.0,0,0,0,0,0,1,1,0
41,Bartosz Bereszyński,DF,Poland,31,1992,0.1,0,0,0,0,0,0,0,,0,0,0,0,0,0,0,0
42,Steven Bergwijn,FW,Netherlands,26,1997,1.0,0,0,0,0,0,0,1,0.0,1,1,0,1,0,0,1,0
43,Medon Berisha,MF,Albania,20,2003,0.2,0,0,0,0,0,0,0,,0,0,0,0,1,1,0,0
44,Victor Bernth Kristiansen,"DF,MF",Denmark,21,2002,1.7,4,3,3,1,0,1,2,50.0,1,2,0,2,0,4,4,1
45,Matúš Bero,"MF,DF",Slovakia,28,1995,0.5,1,1,0,1,0,0,0,,0,0,0,0,1,2,0,0
46,Jaka Bijol,DF,Slovenia,24,1999,4.3,11,6,10,1,0,5,6,83.3,1,10,7,3,6,17,38,0
47,Veljko Birmančević,DF,Serbia,25,1998,0.3,0,0,0,0,0,0,0,,0,0,0,0,2,2,0,0
48,Daley Blind,FW,Netherlands,33,1990,0.0,0,0,0,0,0,0,0,,0,0,0,0,0,0,0,0
49,Bendegúz Bolla,DF,Hungary,24,1999,2.3,4,3,3,0,1,2,4,50.0,2,3,1,2,1,5,9,0
50,Endre Botka,DF,Hungary,29,1994,1.0,3,1,2,1,0,1,1,100.0,0,0,0,0,1,4,3,0
51,Jarrod Bowen,FW,England,27,1996,0.4,1,1,0,1,0,0,1,0.0,1,1,0,1,1,2,1,0
52,Róbert Boženík,FW,Slovakia,24,1999,2.3,3,3,0,3,0,0,1,0.0,1,1,0,1,0,3,3,0
53,Volodymyr Brazhko,MF,Ukraine,22,2002,2.0,8,5,5,3,0,1,1,100.0,0,2,1,1,5,13,4,0
54,David Brekalo,MF,Slovenia,25,1998,0.0,0,0,0,0,0,0,0,,0,0,0,0,0,0,2,0
55,Brian Brobbey,FW,Netherlands,21,2002,0.0,0,0,0,0,0,0,0,,0,0,0,0,0,0,0,0
56,Armando Broja,FW,Albania,22,2001,1.2,1,1,0,0,1,0,0,,0,0,0,0,0,1,1,0
57,Marcelo Brozović,MF,Croatia,31,1992,2.5,1,0,1,0,0,0,2,0.0,2,3,1,2,4,5,4,0
58,Jacob Bruun Larsen,FW,Denmark,25,1998,0.1,0,0,0,0,0,0,0,,0,0,0,0,0,0,0,0
59,Ante Budimir,FW,Croatia,32,1991,1.4,2,2,0,1,1,1,1,100.0,0,3,1,2,0,2,2,0
60,Adam Buksa,FW,Poland,27,1996,1.7,0,0,0,0,0,0,0,,0,4,0,4,0,0,3,0
61,Andrei Burcă,DF,Romania,30,1993,4.0,4,2,3,1,0,3,4,75.0,1,7,4,3,1,5,23,0
62,Riccardo Calafiori,DF,Italy,21,2002,3.0,3,1,3,0,0,2,6,33.3,4,2,1,1,6,9,9,0
63,Hakan Çalhanoğlu,MF,Türkiye,29,1994,3.9,5,4,3,2,0,3,6,50.0,3,3,1,2,1,6,6,0
64,Eduardo Camavinga,MF,France,21,2002,1.9,5,2,3,1,1,2,5,40.0,3,9,1,8,1,6,5,0
65,Andrea Cambiaso,"FW,DF",Italy,23,2000,0.8,4,4,4,0,0,3,4,75.0,1,1,1,0,0,4,0,0
66,Emre Can,MF,Germany,30,1994,1.1,4,3,2,2,0,2,2,100.0,0,2,2,0,1,5,2,0
67,João Cancelo,"DF,MF",Portugal,29,1994,3.8,6,4,2,2,2,4,8,50.0,4,2,0,2,4,10,8,1
68,Yannick Carrasco,"DF,FW",Belgium,30,1993,2.4,4,2,0,4,0,3,7,42.9,4,0,0,0,0,4,3,0
69,Dani Carvajal,DF,Spain,32,1992,5.2,9,5,4,3,2,3,8,37.5,5,7,3,4,6,15,6,2
70,Timothy Castagne,DF,Belgium,28,1995,4.0,1,1,0,1,0,0,2,0.0,2,5,2,3,2,3,14,0
71,Koen Casteels,GK,Belgium,31,1992,4.0,0,0,0,0,0,0,0,,0,0,0,0,0,0,2,0
72,Žan Celar,"FW,MF",Slovenia,24,1999,0.7,1,1,0,1,0,1,1,100.0,0,0,0,0,1,2,2,0
73,Zeki Çelik,"DF,MF",Türkiye,26,1997,1.2,3,0,2,1,0,3,4,75.0,1,1,0,1,0,3,0,0
74,Václav Černý,MF,Czechia,26,1997,0.6,1,1,1,0,0,1,3,33.3,2,1,0,1,0,1,1,0
75,Giorgi Chakvetadze,"MF,FW",Georgia,24,1999,2.7,10,5,7,2,1,6,9,66.7,3,7,2,5,1,11,3,0
76,Federico Chiesa,"FW,MF",Italy,26,1997,2.9,6,4,4,1,1,3,5,60.0,2,0,0,0,3,9,2,0
77,Tomáš Chorý,MF,Czechia,29,1995,0.4,0,0,0,0,0,0,0,,0,0,0,0,0,0,0,0
78,Andreas Christensen,DF,Denmark,27,1996,3.9,4,2,4,0,0,3,3,100.0,0,3,1,2,6,10,11,0
79,Ryan Christie,"MF,FW",Scotland,28,1995,1.1,0,0,0,0,0,0,0,,0,0,0,0,0,0,1,0
80,Mojmir Chytil,FW,Czechia,24,1999,1.2,0,0,0,0,0,0,0,,0,2,0,2,0,0,2,0
81,Alexandru Cicâldău,MF,Romania,26,1997,0.2,2,0,2,0,0,1,1,100.0,0,1,0,1,0,2,0,0
82,Florinel Coman,MF,Romania,25,1998,1.3,1,1,1,0,0,0,0,,0,1,0,1,1,2,2,0
83,Kingsley Coman,MF,France,27,1996,0.2,0,0,0,0,0,0,0,,0,0,0,0,0,0,0,0
84,Francisco Conceição,"FW,MF",Portugal,21,2002,2.0,2,1,0,2,0,0,3,0.0,3,1,0,1,0,2,0,0
85,Diogo Costa,GK,Portugal,24,1999,5.7,0,0,0,0,0,0,0,,0,0,0,0,0,0,2,0
86,Vladimír Coufal,"DF,FW",Czechia,31,1992,3.0,5,4,4,1,0,4,9,44.4,5,7,6,1,2,7,13,0
87,Bryan Cristante,MF,Italy,28,1995,1.5,0,0,0,0,0,0,0,,0,1,1,0,2,2,1,0
88,Kevin Csoboth,DF,Hungary,23,2000,0.1,0,0,0,0,0,0,1,0.0,1,1,0,1,0,0,0,0
89,Marc Cucurella,DF,Spain,25,1998,6.1,12,9,3,6,3,5,8,62.5,3,9,4,5,8,20,12,0
90,Mirlind Daku,FW,Albania,26,1998,0.1,1,0,0,0,1,0,0,,0,0,0,0,0,1,0,0
91,Diogo Dalot,"DF,MF",Portugal,24,1999,1.7,1,1,1,0,0,0,0,,0,2,1,1,1,2,1,0
92,Mikkel Damsgaard,FW,Denmark,23,2000,0.4,1,1,1,0,0,0,0,,0,1,0,1,1,2,1,0
93,Kevin Danso,DF,Austria,25,1998,2.4,0,0,0,0,0,0,1,0.0,1,4,3,1,0,0,13,0
94,Márton Dárdai,DF,Hungary,21,2002,1.9,4,1,4,0,0,2,5,40.0,3,2,0,2,0,4,3,0
95,Matteo Darmian,DF,Italy,34,1989,1.8,1,1,1,0,0,1,2,50.0,1,4,3,1,1,2,6,0
96,Zuriko Davitashvili,"FW,MF",Georgia,22,2001,1.3,4,3,2,0,2,2,3,66.7,1,3,0,3,0,4,1,0
97,Paweł Dawidowicz,DF,Poland,28,1995,2.0,1,0,1,0,0,0,1,0.0,1,4,3,1,0,1,7,0
98,Kevin De Bruyne,MF,Belgium,32,1991,4.0,5,1,3,0,2,1,3,33.3,2,2,0,2,0,5,2,0
99,Charles De Ketelaere,FW,Belgium,22,2001,0.0,0,0,0,0,0,0,0,,0,0,0,0,0,0,0,0
100,Zeno Debast,DF,Belgium,20,2003,1.2,3,1,2,1,0,1,1,100.0,0,3,1,2,0,3,8,0
101,Thomas Delaney,MF,Denmark,32,1991,0.9,0,0,0,0,0,0,0,,0,0,0,0,2,2,2,0
102,Ousmane Dembélé,"FW,MF",France,26,1997,4.0,8,5,0,5,3,3,3,100.0,0,7,0,7,1,9,2,1
103,Merih Demiral,DF,Türkiye,25,1998,2.3,2,2,2,0,0,2,2,100.0,0,8,6,2,4,6,26,1
104,Giovanni Di Lorenzo,"DF,FW",Italy,30,1993,4.0,13,9,9,3,1,7,12,58.3,5,4,1,3,6,19,6,1
105,Rúben Dias,DF,Portugal,26,1997,4.7,2,1,2,0,0,1,3,33.3,2,7,4,3,3,5,12,0
106,Federico Dimarco,"DF,FW",Italy,26,1997,2.5,4,2,0,2,2,2,2,100.0,0,4,2,2,2,6,2,1
107,Berat Djimsiti,DF,Albania,30,1993,3.0,1,0,1,0,0,0,1,0.0,1,8,5,3,2,3,16,0
108,Jeremy Doku,"FW,MF",Belgium,21,2002,3.6,3,2,3,0,0,1,4,25.0,3,1,0,1,1,4,1,1
109,Kasper Dolberg,FW,Denmark,26,1997,0.4,1,1,0,1,0,0,0,,0,0,0,0,0,1,0,0
110,Gianluigi Donnarumma,GK,Italy,24,1999,4.0,0,0,0,0,0,0,0,,0,0,0,0,0,0,2,0
111,David Doudera,FW,Czechia,25,1998,1.0,3,2,3,0,0,3,4,75.0,1,1,0,1,0,3,2,0
112,Artem Dovbyk,FW,Ukraine,26,1997,2.7,2,2,0,0,2,0,0,,0,0,0,0,1,3,2,0
113,Denis Drăguș,FW,Romania,24,1999,3.2,2,1,1,0,1,0,5,0.0,5,4,1,3,1,3,8,0
114,Radu Drăgușin,DF,Romania,21,2002,4.0,1,1,1,0,0,1,3,33.3,2,6,4,2,6,7,33,0
115,Vanja Drkušič,DF,Slovenia,24,1999,4.3,12,7,11,1,0,11,13,84.6,2,3,2,1,1,13,16,0
116,Kwadwo Duah,FW,Switzerland,26,1997,1.2,1,1,0,0,1,1,1,100.0,0,0,0,0,1,2,0,0
117,Martin Dúbravka,GK,Slovakia,35,1989,4.3,0,0,0,0,0,0,0,,0,1,0,1,1,1,3,1
118,Ondrej Duda,MF,Slovakia,29,1994,3.5,7,3,2,4,1,4,6,66.7,2,8,3,5,3,10,5,0
119,Denzel Dumfries,DF,Netherlands,27,1996,5.0,7,5,4,0,3,4,7,57.1,3,5,2,3,3,10,6,0
120,Dávid Ďuriš,"FW,MF",Slovakia,24,1999,0.3,0,0,0,0,0,0,0,,0,0,0,0,0,0,0,0
121,Lasha Dvali,DF,Georgia,28,1995,4.0,8,3,7,1,0,4,7,57.1,3,6,5,1,1,9,24,0
122,Timi Elšnik,MF,Slovenia,25,1998,4.0,13,7,7,4,2,5,7,71.4,2,6,3,3,4,17,5,0
123,Breel Embolo,FW,Switzerland,26,1997,3.3,3,3,0,2,1,0,0,,0,3,0,3,1,4,3,0
124,Christian Eriksen,"MF,FW",Denmark,31,1992,3.9,6,2,1,3,2,3,4,75.0,1,3,0,3,2,8,2,0
125,Eberechi Eze,"DF,MF",England,25,1998,1.1,0,0,0,0,0,0,0,,0,0,0,0,0,0,3,0
126,Wout Faes,DF,Belgium,25,1998,4.0,10,7,5,5,0,3,3,100.0,0,5,3,2,4,14,11,2
127,Nicolò Fagioli,MF,Italy,22,2001,1.1,3,1,2,0,1,1,2,50.0,1,1,1,0,0,3,0,0
128,João Félix,"MF,FW",Portugal,24,1999,1.2,0,0,0,0,0,0,4,0.0,4,0,0,0,0,0,0,0
129,Bruno Fernandes,MF,Portugal,29,1994,4.2,8,5,5,3,0,2,3,66.7,1,6,1,5,2,10,2,0
130,Attila Fiola,DF,Hungary,33,1990,2.0,3,1,2,0,1,2,2,100.0,0,1,1,0,0,3,9,0
131,Phil Foden,"FW,MF",England,23,2000,6.9,7,4,2,3,2,1,4,25.0,3,7,0,7,1,8,4,0
132,Youssouf Fofana,MF,France,25,1999,0.5,1,1,1,0,0,0,3,0.0,3,0,0,0,1,2,1,0
133,Michael Folorunsho,FW,Italy,25,1998,0.0,0,0,0,0,0,0,0,,0,0,0,0,0,0,0,0
134,Przemysław Frankowski,DF,Poland,28,1995,3.0,7,5,6,0,1,3,12,25.0,9,1,0,1,1,8,12,0
135,Davide Frattesi,MF,Italy,24,1999,2.1,2,1,1,1,0,1,2,50.0,1,0,0,0,0,2,1,0
136,Remo Freuler,MF,Switzerland,31,1992,5.1,8,5,3,3,2,1,7,14.3,6,8,0,8,4,12,10,0
137,Jeremie Frimpong,FW,Netherlands,23,2000,1.0,0,0,0,0,0,0,1,0.0,1,0,0,0,0,0,1,0
138,Chris Führich,FW,Germany,26,1998,0.2,1,1,0,0,1,1,1,100.0,0,2,0,2,0,1,0,0
139,Niclas Füllkrug,FW,Germany,30,1993,1.8,1,0,0,0,1,1,1,100.0,0,0,0,0,0,1,3,0
140,Mijat Gaćinović,DF,Serbia,28,1995,0.5,1,1,1,0,0,1,2,50.0,1,2,0,2,0,1,0,0
141,Cody Gakpo,FW,Netherlands,24,1999,5.8,9,8,3,4,2,2,12,16.7,10,5,0,5,4,13,5,0
142,Conor Gallagher,MF,England,23,2000,1.3,1,0,1,0,0,0,2,0.0,2,3,1,2,1,2,4,1
143,Dániel Gazdag,MF,Hungary,27,1996,0.0,1,1,1,0,0,0,0,,0,0,0,0,0,1,0,0
144,Lutsharel Geertruida,DF,Netherlands,23,2000,1.2,4,3,3,1,0,0,0,,0,2,0,2,0,4,0,0
145,Billy Gilmour,MF,Scotland,22,2001,2.0,1,1,0,1,0,0,0,,0,2,0,2,0,1,2,0
146,Olivier Giroud,FW,France,37,1986,0.7,1,0,0,0,1,0,0,,0,0,0,0,0,1,1,0
147,Klaus Gjasula,MF,Albania,34,1989,0.2,0,0,0,0,0,0,2,0.0,2,1,0,1,0,0,0,0
148,Adam Gnezda Čerin,MF,Slovenia,24,1999,4.3,9,5,8,1,0,4,9,44.4,5,7,0,7,5,14,10,0
149,Anthony Gordon,FW,England,22,2001,0.0,0,0,0,0,0,0,0,,0,0,0,0,0,0,0,0
150,Jon Gorenc Stanković,MF,Slovenia,28,1996,1.0,1,1,1,0,0,0,1,0.0,1,3,3,0,0,1,2,0
151,Michael Gregoritsch,FW,Austria,29,1994,1.4,1,1,0,1,0,1,2,50.0,1,1,0,1,0,1,0,0
152,Antoine Griezmann,"MF,FW",France,32,1991,4.4,5,3,2,2,1,4,6,66.7,2,4,0,4,1,6,2,1
153,Florian Grillitsch,MF,Austria,28,1995,2.2,2,1,1,0,1,1,3,33.3,2,0,0,0,6,8,0,0
154,Álex Grimaldo,DF,Spain,28,1995,1.3,1,1,1,0,0,1,2,50.0,1,1,0,1,3,4,4,0
155,Pascal Groß,MF,Germany,32,1991,0.5,1,1,0,1,0,0,0,,0,0,0,0,0,1,0,0
156,Kamil Grosicki,MF,Poland,35,1988,0.2,0,0,0,0,0,0,0,,0,1,0,1,0,0,0,0
157,Nemanja Gudelj,MF,Serbia,32,1991,1.0,1,0,1,0,0,1,1,100.0,0,0,0,0,1,2,1,0
158,Marc Guéhi,DF,England,23,2000,6.3,3,2,1,1,1,1,2,50.0,1,11,6,5,2,5,13,0
159,Péter Gulácsi,GK,Hungary,33,1990,3.0,0,0,0,0,0,0,1,0.0,1,0,0,0,0,0,3,0
160,Arda Güler,"FW,MF",Türkiye,18,2005,3.8,9,5,5,2,2,7,11,63.6,4,0,0,0,3,12,0,0
161,İlkay Gündoğan,MF,Germany,33,1990,4.3,5,4,1,3,1,0,2,0.0,2,0,0,0,1,6,0,0
162,Angus Gunn,GK,Scotland,28,1996,3.0,0,0,0,0,0,0,0,,0,0,0,0,0,0,4,0
163,Mert Günok,GK,Türkiye,34,1989,4.0,0,0,0,0,0,0,0,,0,0,0,0,0,0,1,2
164,Joško Gvardiol,DF,Croatia,22,2002,3.0,5,3,3,1,1,2,4,50.0,2,2,1,1,5,10,4,0
165,Giorgi Gwelesiani,DF,Georgia,32,1991,1.8,3,3,3,0,0,3,5,60.0,2,3,3,0,2,5,15,1
166,Norbert Gyömbér,DF,Slovakia,31,1992,0.4,0,0,0,0,0,0,0,,0,0,0,0,1,1,2,0
167,Ianis Hagi,MF,Romania,25,1998,2.1,5,3,2,1,2,2,4,50.0,2,1,0,1,0,5,4,0
168,Dávid Hancko,DF,Slovakia,26,1997,4.1,10,5,6,4,0,4,11,36.4,7,7,2,5,3,13,10,0
169,Grant Hanley,DF,Scotland,32,1991,2.5,2,0,1,1,0,0,0,,0,2,1,1,1,3,11,0
170,Lukáš Haraslín,FW,Slovakia,27,1996,2.9,4,4,2,1,1,4,6,66.7,2,1,0,1,3,7,5,0
171,Kai Havertz,"FW,MF",Germany,24,1999,4.3,2,1,1,1,0,2,2,100.0,0,4,0,4,0,2,8,0
172,Jack Hendry,DF,Scotland,28,1995,2.9,2,1,1,1,0,2,2,100.0,0,2,2,0,1,3,10,0
173,Benjamin Henrichs,DF,Germany,26,1997,0.1,0,0,0,0,0,0,0,,0,0,0,0,0,0,0,0
174,Theo Hernández,DF,France,26,1997,6.3,10,6,7,2,1,6,9,66.7,3,6,5,1,3,13,12,2
175,Morten Hjulmand,MF,Denmark,24,1999,2.7,3,1,1,2,0,2,5,40.0,3,3,1,2,1,4,3,1
176,Adam Hložek,MF,Czechia,21,2002,1.2,1,0,0,0,1,0,1,0.0,1,0,0,0,1,2,1,0
177,Tomáš Holeš,DF,Czechia,30,1993,3.0,10,5,5,3,2,7,10,70.0,3,4,2,2,2,12,12,0
178,Arbër Hoxha,"FW,MF",Albania,25,1998,0.6,2,2,1,1,0,2,2,100.0,0,0,0,0,0,2,0,0
179,Robin Hranáč,DF,Czechia,24,2000,3.0,2,1,1,1,0,2,2,100.0,0,3,1,2,0,2,12,1
180,Elseid Hysaj,DF,Albania,29,1994,2.0,1,1,0,1,0,1,5,20.0,4,3,2,1,0,1,2,0
181,Pierre Højbjerg,MF,Denmark,28,1995,3.9,10,7,5,5,0,7,13,53.8,6,5,0,5,3,13,5,0
182,Rasmus Højlund,FW,Denmark,20,2003,3.2,3,1,0,1,2,1,4,25.0,3,0,0,0,1,4,1,0
183,Ivan Ilić,MF,Serbia,22,2001,2.2,6,4,4,1,1,3,3,100.0,0,4,3,1,0,6,3,1
184,Josip Iličić,"FW,MF",Slovenia,36,1988,0.3,2,1,1,0,1,1,1,100.0,0,0,0,0,0,2,0,0
185,Gonçalo Inácio,DF,Portugal,22,2001,1.3,2,2,1,1,0,2,5,40.0,3,6,0,6,1,3,5,0
186,Luka Ivanušec,MF,Croatia,25,1998,0.2,0,0,0,0,0,0,0,,0,0,0,0,0,0,1,0
187,Erik Janža,DF,Slovenia,30,1993,3.0,4,4,3,1,0,1,5,20.0,4,1,1,0,2,6,8,0
188,Jorginho,MF,Italy,32,1991,2.4,6,2,6,0,0,3,8,37.5,5,3,0,3,4,10,1,0
189,Joselu,FW,Spain,33,1990,1.0,0,0,0,0,0,0,1,0.0,1,1,0,1,0,0,3,0
190,Diogo Jota,"FW,MF",Portugal,27,1996,1.1,3,2,0,2,1,0,0,,0,1,0,1,0,3,0,0
191,Luka Jović,"MF,FW",Serbia,26,1997,1.1,0,0,0,0,0,0,0,,0,0,0,0,0,0,1,0
192,Josip Juranović,DF,Croatia,28,1995,1.0,3,3,1,2,0,2,3,66.7,1,1,1,0,1,4,1,0
193,David Jurásek,DF,Czechia,23,2000,1.8,3,2,2,1,0,2,5,40.0,3,1,1,0,1,4,2,0
194,Matěj Jurásek,"DF,MF",Czechia,20,2003,0.5,2,1,0,1,1,2,4,50.0,2,0,0,0,0,2,1,0
195,Ferdi Kadioglu,"DF,MF",Türkiye,24,1999,5.0,18,12,9,7,2,10,13,76.9,3,5,1,4,7,25,10,0
196,İrfan Kahveci,FW,Türkiye,28,1995,0.1,0,0,0,0,0,0,0,,0,0,0,0,0,0,0,0
197,Otar Kakabadze,"DF,MF",Georgia,28,1995,4.0,12,8,10,1,1,10,18,55.6,8,3,1,2,4,16,8,0
198,Harry Kane,FW,England,30,1993,6.7,4,3,2,2,0,1,3,33.3,2,2,2,0,1,5,0,0
199,N'Golo Kanté,MF,France,32,1991,5.7,12,9,6,3,3,4,5,80.0,1,6,1,5,6,18,7,0
200,Žan Karničnik,DF,Slovenia,29,1994,4.3,8,4,7,1,0,7,12,58.3,5,5,3,2,8,16,11,0
201,Guram Kashia,DF,Georgia,36,1987,4.0,7,4,5,2,0,4,4,100.0,0,13,12,1,1,8,31,1
202,Milos Kerkez,DF,Hungary,20,2003,2.6,4,2,3,1,0,3,5,60.0,2,0,0,0,0,4,7,1
203,Semih Kılıçsoy,FW,Türkiye,18,2005,0.0,0,0,0,0,0,0,0,,0,0,0,0,0,0,0,0
204,Joshua Kimmich,DF,Germany,28,1995,5.3,7,4,5,0,2,4,12,33.3,8,6,2,4,6,13,6,0
205,Otar Kiteishvili,MF,Georgia,27,1996,1.4,4,4,4,0,0,2,6,33.3,4,3,1,2,0,4,3,0
206,Jakub Kiwior,DF,Poland,23,2000,3.0,7,4,6,1,0,3,5,60.0,2,4,2,2,5,12,9,0
207,László Kleinheisler,MF,Hungary,29,1994,0.6,0,0,0,0,0,0,1,0.0,1,0,0,0,0,0,0,0
208,Giorgi Kochorashvili,MF,Georgia,24,1999,4.0,9,5,5,4,0,5,6,83.3,1,6,4,2,5,14,6,1
209,Orkun Kökçü,MF,Türkiye,23,2000,2.5,3,2,2,0,1,1,4,25.0,3,3,1,2,1,4,2,0
210,Randal Kolo Muani,FW,France,25,1998,2.2,1,0,1,0,0,1,1,100.0,0,2,1,1,1,2,4,0
211,Yukhym Konoplia,DF,Ukraine,24,1999,0.8,1,0,0,0,1,0,0,,0,1,0,1,0,1,0,0
212,Ezri Konsa,DF,England,26,1997,1.0,2,0,2,0,0,1,1,100.0,0,3,2,1,0,2,8,0
213,Filip Kostić,DF,Serbia,31,1992,0.5,1,0,1,0,0,1,2,50.0,1,1,0,1,0,1,1,0
214,Jules Koundé,DF,France,25,1998,6.3,18,12,7,5,6,10,17,58.8,7,5,0,5,2,20,22,0
215,Mateo Kovačić,MF,Croatia,29,1994,2.5,8,6,2,5,1,2,5,40.0,3,2,1,1,3,11,0,0
216,Matej Kovar,GK,Czechia,23,2000,0.4,0,0,0,0,0,0,0,,0,0,0,0,0,0,0,0
217,Andrej Kramarić,FW,Croatia,32,1991,2.7,0,0,0,0,0,0,0,,0,3,1,2,1,1,1,0
218,Ladislav Krejčí,DF,Czechia,24,1999,3.0,3,2,3,0,0,0,3,0.0,3,1,1,0,5,8,9,0
219,Toni Kroos,MF,Germany,34,1990,5.2,9,4,4,4,1,3,5,60.0,2,3,0,3,7,16,5,0
220,Jan Kuchta,FW,Czechia,27,1997,1.1,2,1,2,0,0,1,1,100.0,0,0,0,0,0,2,2,0
221,Juraj Kucka,MF,Slovakia,36,1987,3.9,1,1,0,1,0,1,7,14.3,6,3,1,2,2,3,4,0
222,Jasmin Kurtić,FW,Slovenia,35,1989,0.0,0,0,0,0,0,0,0,,0,0,0,0,0,0,0,0
223,Khvicha Kvaratskhelia,FW,Georgia,22,2001,3.8,4,3,0,4,0,3,6,50.0,3,2,2,0,0,4,2,0
224,Nika Kvekveskiri,MF,Georgia,31,1992,0.1,0,0,0,0,0,0,1,0.0,1,0,0,0,1,1,0,0
225,Giorgi Kvilitaia,FW,Georgia,30,1993,0.0,0,0,0,0,0,0,0,,0,0,0,0,0,0,0,0
226,Saba Kvirkvelia,DF,Georgia,31,1992,2.0,4,3,3,1,0,3,3,100.0,0,2,2,0,1,5,17,1
227,Qazim Laçi,"MF,FW",Albania,28,1996,1.8,4,3,1,2,1,1,2,50.0,1,3,0,3,3,7,5,0
228,Konrad Laimer,"MF,FW",Austria,26,1997,3.0,5,1,2,1,2,3,6,50.0,3,3,0,3,2,7,2,0
229,Ádám Lang,DF,Hungary,31,1993,0.5,0,0,0,0,0,0,0,,0,0,0,0,1,1,3,0
230,Aymeric Laporte,DF,Spain,29,1994,5.8,3,3,2,1,0,2,3,66.7,1,4,3,1,6,9,27,1
231,Robin Le Normand,DF,Spain,27,1996,4.9,6,2,5,1,0,5,8,62.5,3,2,1,1,2,8,14,0
232,Rafael Leão,FW,Portugal,24,1999,3.2,2,2,2,0,0,1,2,50.0,1,1,0,1,1,3,1,0
233,Robert Lewandowski,FW,Poland,35,1988,1.3,2,2,0,0,2,0,0,,0,2,0,2,0,2,3,0
234,Philipp Lienhart,DF,Austria,27,1996,2.4,2,2,1,1,0,2,3,66.7,1,2,2,0,2,4,10,0
235,Ondřej Lingr,"MF,FW",Czechia,25,1998,0.9,2,2,0,2,0,0,1,0.0,1,1,0,1,0,2,0,0
236,Dominik Livaković,GK,Croatia,29,1995,3.0,0,0,0,0,0,0,0,,0,0,0,0,1,1,2,0
237,Stanislav Lobotka,MF,Slovakia,29,1994,4.3,7,6,3,4,0,2,6,33.3,4,3,0,3,3,10,9,0
238,Saba Lobzhanidze,FW,Georgia,29,1994,0.1,0,0,0,0,0,0,0,,0,0,0,0,0,0,3,0
239,Luka Lochoshvili,"DF,MF",Georgia,25,1998,1.9,4,3,3,0,1,3,5,60.0,2,1,0,1,3,7,11,0
240,Fermin López,MF,Spain,20,2003,0.3,1,1,0,0,1,0,1,0.0,1,0,0,0,0,1,0,0
241,Romelu Lukaku,FW,Belgium,30,1993,4.0,0,0,0,0,0,0,0,,0,0,0,0,0,0,3,0
242,Dodi Lukebakio,"FW,DF",Belgium,26,1997,0.7,1,1,0,0,1,0,0,,0,1,0,1,0,1,0,0
243,Saša Lukić,MF,Serbia,27,1996,2.3,8,5,1,5,2,5,6,83.3,1,2,0,2,3,11,5,0
244,Andriy Lunin,GK,Ukraine,24,1999,1.0,0,0,0,0,0,0,0,,0,0,0,0,0,0,0,2
245,Mike Maignan,GK,France,28,1995,6.3,1,0,1,0,0,1,1,100.0,0,0,0,0,0,1,5,0
246,Kobbie Mainoo,MF,England,18,2005,4.1,8,5,1,6,1,4,5,80.0,1,1,0,1,6,14,3,0
247,Lovro Majer,"FW,MF",Croatia,26,1998,1.6,4,3,1,2,1,2,2,100.0,0,4,0,4,0,4,0,0
248,Donyell Malen,FW,Netherlands,25,1999,2.1,0,0,0,0,0,0,0,,0,0,0,0,2,2,2,0
249,Ruslan Malinovskyi,MF,Ukraine,30,1993,0.4,5,1,1,4,0,1,3,33.3,2,1,0,1,1,6,3,0
250,Giorgi Mamardashvili,GK,Georgia,23,2000,4.0,0,0,0,0,0,0,0,,0,0,0,0,0,0,2,0
251,Dennis Man,MF,Romania,25,1998,3.0,3,0,1,2,0,2,4,50.0,2,0,0,0,1,4,0,0
252,Rey Manaj,FW,Albania,26,1997,1.7,2,2,1,0,1,0,1,0.0,1,0,0,0,1,3,2,0
253,Gianluca Mancini,DF,Italy,27,1996,1.0,0,0,0,0,0,0,0,,0,3,1,2,0,0,1,0
254,Orel Mangala,MF,Belgium,25,1998,1.5,4,3,2,1,1,1,3,33.3,2,2,1,1,4,8,0,0
255,Marius Marin,MF,Romania,25,1998,3.4,9,3,8,1,0,5,10,50.0,5,4,1,3,4,13,6,0
256,Răzvan Marin,MF,Romania,27,1996,3.9,7,2,3,4,0,4,9,44.4,5,3,2,1,0,7,6,0
257,Ádám Martin,"FW,DF",Hungary,29,1994,0.5,0,0,0,0,0,0,0,,0,2,2,0,0,0,0,0
258,Mykola Matviyenko,DF,Ukraine,27,1996,3.0,4,3,2,2,0,2,4,50.0,2,4,2,2,4,8,9,1
259,Kylian Mbappé,FW,France,25,1998,5.2,1,0,1,0,0,0,2,0.0,2,4,1,3,0,1,0,0
260,John McGinn,"MF,FW",Scotland,29,1994,2.6,1,1,0,1,0,1,4,25.0,3,2,0,2,1,2,0,0
261,Callum McGregor,MF,Scotland,30,1993,2.7,2,1,1,1,0,1,4,25.0,3,2,1,1,2,4,6,0
262,Scott McKenna,DF,Scotland,27,1996,1.5,1,0,1,0,0,1,2,50.0,1,1,1,0,2,3,5,0
263,Kenny McLean,MF,Scotland,32,1992,0.5,3,2,1,2,0,3,3,100.0,0,0,0,0,0,3,0,0
264,Scott McTominay,MF,Scotland,27,1996,3.0,4,2,2,1,1,1,2,50.0,1,2,1,1,3,7,7,0
265,Anzor Mekvabishvili,MF,Georgia,22,2001,2.1,6,3,3,3,0,3,3,100.0,0,4,1,3,5,11,5,0
266,Memphis,"FW,MF",Netherlands,29,1994,5.1,1,1,0,1,0,1,4,25.0,3,1,0,1,1,2,1,0
267,Nuno Mendes,DF,Portugal,21,2002,4.7,12,6,7,3,2,6,11,54.5,5,6,2,4,5,17,11,0
268,Mikel Merino,"MF,FW",Spain,27,1996,2.0,4,3,0,3,1,2,3,66.7,1,2,1,1,2,6,4,0
269,Valentin Mihaila,MF,Romania,23,2000,1.3,3,2,2,0,1,0,1,0.0,1,0,0,0,2,5,5,0
270,Srđan Mijailović,DF,Serbia,30,1993,0.8,3,1,1,2,0,3,4,75.0,1,1,0,1,1,4,4,0
271,Georges Mikautadze,FW,Georgia,23,2000,3.8,3,1,1,2,0,1,4,25.0,3,0,0,0,0,3,0,0
272,Nikola Milenković,DF,Serbia,26,1997,3.0,3,3,1,2,0,1,2,50.0,1,2,2,0,2,5,11,0
273,Sergej Milinković-Savić,MF,Serbia,28,1995,1.3,2,2,0,2,0,1,2,50.0,1,1,1,0,1,3,2,0
274,Mario Mitaj,DF,Albania,20,2003,3.0,8,4,6,1,1,8,11,72.7,3,4,0,4,7,15,11,0
275,Aleksandar Mitrović,FW,Serbia,29,1994,2.7,0,0,0,0,0,0,1,0.0,1,2,0,2,0,0,4,0
276,Maximilian Mittelstädt,DF,Germany,26,1997,3.4,4,2,1,1,2,3,5,60.0,2,6,0,6,2,6,8,0
277,Filip Mladenović,DF,Serbia,32,1991,1.2,2,1,0,1,1,1,5,20.0,4,0,0,0,2,4,1,0
278,Jan Mlakar,MF,Slovenia,25,1998,3.3,3,3,2,1,0,1,2,50.0,1,2,1,1,1,4,9,0
279,Jakub Moder,MF,Poland,24,1999,2.0,2,2,0,2,0,1,3,33.3,2,3,1,2,1,3,8,0
280,Luka Modrić,MF,Croatia,38,1985,2.6,4,4,4,0,0,1,2,50.0,1,1,0,1,1,5,1,0
281,Vasile Mogos,DF,Romania,31,1992,0.4,0,0,0,0,0,0,1,0.0,1,0,0,0,0,0,1,0
282,Álvaro Morata,FW,Spain,31,1992,5.0,6,4,1,2,3,0,4,0.0,4,0,0,0,0,6,3,0
283,Lewis Morgan,DF,Scotland,27,1996,0.0,0,0,0,0,0,0,0,,0,0,0,0,1,1,0,0
284,Ernest Muçi,FW,Albania,22,2001,0.2,0,0,0,0,0,0,0,,0,0,0,0,0,0,0,0
285,Mykhailo Mudryk,"FW,MF",Ukraine,23,2001,1.9,2,2,1,0,1,2,4,50.0,2,0,0,0,0,2,1,1
286,Mert Müldür,"DF,MF",Türkiye,24,1999,3.8,7,6,3,1,3,7,9,77.8,2,8,1,7,5,12,12,0
287,Thomas Müller,"MF,FW",Germany,34,1989,0.6,2,1,1,1,0,1,2,50.0,1,0,0,0,0,2,1,0
288,Jamal Musiala,FW,Germany,20,2003,4.7,6,4,1,4,1,2,3,66.7,1,7,0,7,4,10,2,0
289,Phillipp Mwene,DF,Austria,30,1994,2.2,6,4,3,3,0,3,6,50.0,3,5,2,3,0,6,6,0
290,Vitaliy Mykolenko,DF,Ukraine,24,1999,0.6,0,0,0,0,0,0,0,,0,2,1,1,0,0,1,0
291,Joakim Mæhle,"DF,MF",Denmark,26,1997,3.1,6,4,3,2,1,3,8,37.5,5,2,0,2,3,9,5,1
292,Nacho,DF,Spain,34,1990,2.9,2,1,1,1,0,1,3,33.3,2,3,2,1,0,2,16,0
293,Ádám Nagy,MF,Hungary,28,1995,1.8,3,2,2,1,0,2,2,100.0,0,1,0,1,4,7,3,0
294,Zsolt Nagy,DF,Hungary,30,1993,0.2,2,0,1,1,0,0,0,,0,0,0,0,0,2,2,0
295,Jesús Navas,DF,Spain,38,1985,1.7,3,2,1,2,0,0,0,,0,2,0,2,1,4,11,0
296,Dan Ndoye,"MF,DF",Switzerland,23,2000,4.5,5,3,4,1,0,1,2,50.0,1,3,0,3,2,7,2,0
297,Pedro Neto,"DF,FW",Portugal,23,2000,1.3,5,1,2,2,1,2,2,100.0,0,0,0,0,2,7,1,0
298,Manuel Neuer,GK,Germany,37,1986,5.3,0,0,0,0,0,0,0,,0,0,0,0,0,0,1,1
299,João Neves,MF,Portugal,19,2004,0.9,0,0,0,0,0,0,0,,0,1,0,1,5,5,0,0
300,Rúben Neves,MF,Portugal,26,1997,1.4,3,1,0,2,1,0,1,0.0,1,3,1,2,1,4,1,0
301,Florin Niță,GK,Romania,36,1987,4.0,0,0,0,0,0,0,0,,0,0,0,0,0,0,2,0
302,Matheus Nunes,MF,Portugal,25,1998,0.2,0,0,0,0,0,0,0,,0,0,0,0,0,0,0,0
303,Christian Nørgaard,MF,Denmark,29,1994,0.4,1,0,0,1,0,1,1,100.0,0,0,0,0,0,1,1,0
304,Adam Obert,DF,Slovakia,21,2002,0.3,1,1,0,1,0,1,1,100.0,0,0,0,0,0,1,1,0
305,Jan Oblak,GK,Slovenia,31,1993,4.3,0,0,0,0,0,0,0,,0,0,0,0,0,0,1,0
306,Darius Olaru,MF,Romania,25,1998,0.3,0,0,0,0,0,0,0,,0,0,0,0,0,0,0,0
307,Dani Olmo,"MF,FW",Spain,25,1998,4.8,4,3,1,2,1,3,6,50.0,3,2,1,1,2,6,2,0
308,Amadou Onana,MF,Belgium,22,2001,4.0,8,6,3,4,1,4,5,80.0,1,7,1,6,3,11,4,2
309,Loïs Openda,FW,Belgium,23,2000,0.8,2,1,0,0,2,0,0,,0,1,0,1,1,3,1,0
310,Willi Orban,DF,Hungary,31,1992,3.0,7,7,7,0,0,3,3,100.0,0,9,7,2,1,8,9,1
311,Mikel Oyarzabal,FW,Spain,26,1997,2.2,2,1,0,0,2,0,0,,0,2,0,2,0,2,4,0
312,Salih Özcan,MF,Türkiye,26,1998,1.7,6,3,1,5,0,2,3,66.7,1,0,0,0,7,13,4,0
313,João Palhinha,MF,Portugal,28,1995,3.3,15,9,5,8,2,7,10,70.0,3,6,1,5,8,23,6,0
314,Cole Palmer,"MF,FW",England,21,2002,1.7,2,0,1,0,1,1,2,50.0,1,1,0,1,0,2,1,0
315,Mario Pašalić,"FW,MF",Croatia,28,1995,1.3,1,0,1,0,0,0,0,,0,0,0,0,0,1,2,0
316,Strahinja Pavlović,DF,Serbia,22,2001,3.0,11,6,7,3,1,9,14,64.3,5,2,0,2,4,15,10,0
317,Pedri,MF,Spain,21,2002,2.1,6,3,1,4,1,2,4,50.0,2,0,0,0,1,7,0,0
318,Peter Pekarík,DF,Slovakia,37,1986,4.2,1,0,1,0,0,1,4,25.0,3,4,3,1,7,8,11,0
319,Lorenzo Pellegrini,"FW,MF",Italy,27,1996,2.4,2,0,1,1,0,1,4,25.0,3,3,0,3,2,4,2,0
320,Patrick Pentz,GK,Austria,27,1997,4.0,0,0,0,0,0,0,0,,0,0,0,0,0,0,3,1
321,Pepe,DF,Portugal,40,1983,4.5,9,5,5,3,1,7,13,53.8,6,3,2,1,5,14,26,1
322,Danilo Pereira,DF,Portugal,32,1991,1.0,0,0,0,0,0,0,0,,0,0,0,0,1,1,2,0
323,Ayoze Pérez,FW,Spain,30,1993,0.1,0,0,0,0,0,0,0,,0,1,0,1,0,0,0,0
324,Ivan Perišić,"DF,FW",Croatia,34,1989,1.5,0,0,0,0,0,0,0,,0,1,0,1,1,1,3,0
325,Bruno Petković,FW,Croatia,29,1994,1.0,0,0,0,0,0,0,1,0.0,1,0,0,0,0,0,1,0
326,Krzysztof Piątek,FW,Poland,28,1995,0.7,1,1,0,1,0,0,0,,0,0,0,0,0,1,0,0
327,Jordan Pickford,GK,England,29,1994,7.7,0,0,0,0,0,0,0,,0,0,0,0,1,1,1,0
328,Jakub Piotrowski,MF,Poland,26,1997,0.6,0,0,0,0,0,0,0,,0,0,0,0,0,0,1,0
329,Marin Pongračić,DF,Croatia,26,1997,2.0,2,1,2,0,0,0,4,0.0,4,6,3,3,2,4,9,0
330,Ryan Porteous,DF,Scotland,24,1999,0.5,2,1,2,0,0,2,2,100.0,0,0,0,0,0,2,1,0
331,Stefan Posch,DF,Austria,26,1997,4.0,15,9,4,8,3,9,13,69.2,4,11,4,7,6,21,11,0
332,Yussuf Poulsen,"FW,MF",Denmark,29,1994,0.6,1,0,0,0,1,1,2,50.0,1,1,0,1,0,1,1,0
333,Alexander Prass,DF,Austria,22,2001,1.8,7,2,4,2,1,4,10,40.0,6,1,0,1,2,9,1,0
334,Lukáš Provod,MF,Czechia,27,1996,2.6,5,5,2,1,2,3,5,60.0,2,3,1,2,0,5,2,0
335,George Pușcaș,FW,Romania,27,1996,0.4,0,0,0,0,0,0,1,0.0,1,0,0,0,0,0,1,0
336,Leopold Querfeld,DF,Austria,20,2003,0.3,2,2,1,1,0,2,2,100.0,0,0,0,0,1,3,1,0
337,Adrien Rabiot,MF,France,28,1995,4.1,9,5,3,5,1,4,5,80.0,1,3,0,3,1,10,2,0
338,Bogdan Racovitan,DF,Romania,23,2000,0.6,0,0,0,0,0,0,1,0.0,1,2,2,0,1,1,3,1
339,Predrag Rajković,GK,Serbia,28,1995,3.0,0,0,0,0,0,0,0,,0,0,0,0,0,0,0,0
340,Anthony Ralston,DF,Scotland,25,1998,2.9,3,2,3,0,0,1,3,33.3,2,5,1,4,1,4,7,1
341,Ylber Ramadani,MF,Albania,27,1996,2.9,6,3,2,3,1,5,9,55.6,4,8,3,5,4,10,4,0
342,Gonçalo Ramos,FW,Portugal,22,2001,0.3,0,0,0,0,0,0,0,,0,1,0,1,0,0,1,0
343,Giacomo Raspadori,FW,Italy,23,2000,0.9,3,1,1,2,0,1,2,50.0,1,0,0,0,0,3,0,0
344,Andrei Ratiu,DF,Romania,25,1998,4.0,6,5,4,2,0,4,5,80.0,1,6,2,4,6,12,15,0
345,David Raum,DF,Germany,25,1998,1.8,5,5,3,1,1,5,7,71.4,2,1,0,1,0,5,1,0
346,David Raya,GK,Spain,28,1995,1.0,0,0,0,0,0,0,0,,0,0,0,0,0,0,0,0
347,Tijjani Reijnders,MF,Netherlands,25,1998,5.5,8,6,1,7,0,3,5,60.0,2,5,1,4,6,14,4,0
348,Mateo Retegui,FW,Italy,24,1999,1.7,2,1,0,1,1,0,1,0.0,1,1,0,1,0,2,0,0
349,Declan Rice,MF,England,25,1999,7.7,19,15,11,6,2,5,8,62.5,3,5,1,4,8,27,10,0
350,Fabian Rieder,MF,Switzerland,21,2002,2.4,7,3,1,4,2,3,5,60.0,2,2,1,1,0,7,1,0
351,Andrew Robertson,DF,Scotland,29,1994,3.0,8,5,4,4,0,8,10,80.0,2,2,0,2,1,9,10,1
352,Rodri,MF,Spain,27,1996,5.8,14,8,4,9,1,4,10,40.0,6,7,4,3,1,15,10,0
353,Ricardo Rodríguez,DF,Switzerland,31,1992,5.3,7,6,2,3,2,3,4,75.0,1,5,2,3,3,10,19,0
354,Taras Romanchuk,MF,Poland,32,1991,0.6,2,1,2,0,0,1,2,50.0,1,1,0,1,0,2,1,0
355,Cristiano Ronaldo,FW,Portugal,38,1985,5.4,1,1,0,0,1,1,1,100.0,0,1,1,0,0,1,1,0
356,Antonio Rüdiger,DF,Germany,30,1993,5.3,8,4,7,1,0,6,6,100.0,0,10,6,4,2,10,20,0
357,Fabián Ruiz Peña,MF,Spain,27,1996,6.0,9,6,5,0,4,6,10,60.0,4,3,0,3,4,13,5,1
358,Adrian Rus,MF,Romania,27,1996,0.2,0,0,0,0,0,0,0,,0,0,0,0,0,0,0,0
359,Marcel Sabitzer,"FW,MF",Austria,29,1994,4.0,2,1,0,1,1,2,2,100.0,0,2,0,2,3,5,1,0
360,Bukayo Saka,"FW,DF",England,22,2001,7.0,5,4,2,3,0,2,3,66.7,1,7,0,7,1,6,12,0
361,Bartosz Salamon,DF,Poland,32,1991,0.9,3,2,2,1,0,2,2,100.0,0,1,0,1,2,5,7,0
362,William Saliba,DF,France,22,2001,6.3,5,2,3,2,0,2,3,66.7,1,6,3,3,4,9,30,0
363,Roland Sallai,MF,Hungary,26,1997,3.0,4,2,1,1,2,1,2,50.0,1,0,0,0,1,5,1,0
364,Lazar Samardzic,MF,Serbia,21,2002,0.6,0,0,0,0,0,0,0,,0,0,0,0,0,0,0,0
365,Leroy Sané,FW,Germany,28,1996,2.3,1,1,1,0,0,0,5,0.0,5,2,0,2,0,1,0,0
366,Leo Sauer,FW,Slovakia,18,2005,0.1,0,0,0,0,0,0,0,,0,0,0,0,0,0,0,0
367,Gianluca Scamacca,FW,Italy,25,1999,2.8,1,1,0,0,1,0,0,,0,0,0,0,2,3,1,0
368,András Schäfer,MF,Hungary,24,1999,3.0,6,3,0,6,0,1,3,33.3,2,4,1,3,1,7,3,0
369,Fabian Schär,DF,Switzerland,32,1991,5.3,10,4,7,0,3,4,7,57.1,3,6,4,2,9,19,24,0
370,Patrik Schick,FW,Czechia,28,1996,1.4,1,1,1,0,0,0,3,0.0,3,1,0,1,1,2,4,0
371,Nico Schlotterbeck,DF,Germany,24,1999,1.3,1,1,0,1,0,0,2,0.0,2,1,0,1,2,3,8,1
372,Kasper Schmeichel,GK,Denmark,37,1986,4.0,0,0,0,0,0,0,0,,0,0,0,0,0,0,0,0
373,Romano Schmid,"FW,MF",Austria,24,2000,1.6,2,1,0,1,1,1,3,33.3,2,6,0,6,0,2,2,0
374,Jerdy Schouten,MF,Netherlands,27,1997,5.6,7,3,2,4,1,1,5,20.0,4,5,2,3,5,12,8,0
375,Ivan Schranz,FW,Slovakia,30,1993,3.7,3,1,3,0,0,1,3,33.3,2,0,0,0,2,5,9,0
376,Taulant Seferi,FW,Albania,27,1996,1.0,2,2,0,2,0,2,5,40.0,3,0,0,0,2,4,2,0
377,Nicolas Seiwald,MF,Austria,22,2001,4.0,15,7,5,8,2,4,11,36.4,7,5,1,4,6,21,8,0
378,Nélson Semedo,DF,Portugal,30,1993,1.1,3,2,2,1,0,2,6,33.3,4,1,0,1,0,3,0,0
379,Benjamin Šeško,FW,Slovenia,20,2003,4.0,3,1,1,1,1,1,5,20.0,4,3,1,2,0,3,5,0
380,Petr Ševčík,MF,Czechia,29,1994,0.2,0,0,0,0,0,0,0,,0,0,0,0,0,0,0,0
381,Stephan El Shaarawy,FW,Italy,31,1992,0.5,0,0,0,0,0,0,0,,0,0,0,0,0,0,2,0
382,Lawrence Shankland,FW,Scotland,28,1995,0.3,1,0,1,0,0,1,1,100.0,0,2,0,2,0,1,1,0
383,Mykola Shaparenko,MF,Ukraine,25,1998,2.4,3,0,2,1,0,3,4,75.0,1,4,0,4,3,6,1,0
384,Xherdan Shaqiri,"MF,FW",Switzerland,32,1991,0.8,0,0,0,0,0,0,0,,0,0,0,0,0,0,0,0
385,Luke Shaw,DF,England,28,1995,2.0,3,2,2,1,0,3,3,100.0,0,2,0,2,2,5,6,0
386,Vincent Sierro,MF,Switzerland,28,1995,0.4,0,0,0,0,0,0,1,0.0,1,1,1,0,0,0,1,0
387,António Silva,DF,Portugal,20,2003,0.8,1,1,1,0,0,0,0,,0,0,0,0,0,1,2,1
388,Bernardo Silva,"FW,MF",Portugal,29,1994,4.7,5,4,1,3,1,1,6,16.7,5,2,0,2,0,5,3,0
389,Unai Simón,GK,Spain,26,1997,6.3,0,0,0,0,0,0,0,,0,0,0,0,0,0,3,1
390,Xavi Simons,"MF,FW",Netherlands,20,2003,5.0,8,5,3,4,1,5,6,83.3,1,7,0,7,5,13,0,0
391,Michał Skóraś,DF,Poland,23,2000,0.3,1,1,0,1,0,0,0,,0,0,0,0,1,2,1,0
392,Łukasz Skorupski,GK,Poland,32,1991,1.0,0,0,0,0,0,0,0,,0,0,0,0,0,0,4,0
393,Andreas Skov Olsen,"MF,FW",Denmark,24,1999,1.4,1,1,0,0,1,1,2,50.0,1,2,0,2,0,1,2,0
394,Milan Škriniar,DF,Slovakia,28,1995,4.3,3,1,3,0,0,2,4,50.0,2,4,4,0,2,5,17,0
395,Bartosz Slisz,MF,Poland,24,1999,1.2,1,1,0,0,1,0,0,,0,1,0,1,2,3,3,0
396,Yann Sommer,GK,Switzerland,35,1988,5.3,0,0,0,0,0,0,0,,0,0,0,0,0,0,2,0
397,Deian Sorescu,"MF,DF",Romania,26,1997,0.4,0,0,0,0,0,0,0,,0,1,0,1,1,1,1,0
398,Borna Sosa,DF,Croatia,26,1998,0.1,0,0,0,0,0,0,1,0.0,1,1,1,0,0,0,0,0
399,Tomáš Souček,MF,Czechia,28,1995,3.0,5,3,2,2,1,3,6,50.0,3,6,2,4,3,8,5,0
400,Andraž Šporar,FW,Slovenia,29,1994,3.8,2,2,1,0,1,1,1,100.0,0,2,1,1,0,2,4,0
401,Nicolae Stanciu,"MF,FW",Romania,30,1993,3.9,3,2,1,2,0,1,4,25.0,3,1,1,0,1,4,5,0
402,Jindřich Staněk,GK,Czechia,27,1996,2.6,0,0,0,0,0,0,0,,0,0,0,0,0,0,1,0
403,Josip Stanišić,DF,Croatia,23,2000,2.0,10,8,3,5,2,5,9,55.6,4,3,1,2,4,14,2,0
404,Renato Steffen,DF,Switzerland,32,1991,0.0,0,0,0,0,0,0,0,,0,0,0,0,0,0,0,0
405,Taras Stepanenko,MF,Ukraine,34,1989,0.9,3,3,3,0,0,3,5,60.0,2,2,1,1,1,4,2,0
406,Leonidas Stergiou,DF,Switzerland,21,2002,0.5,4,2,3,1,0,1,3,33.3,2,0,0,0,0,4,4,0
407,Petar Stojanović,MF,Slovenia,28,1995,3.5,6,5,5,1,0,3,8,37.5,5,4,1,3,1,7,4,0
408,John Stones,DF,England,29,1994,7.7,4,3,2,1,1,2,2,100.0,0,4,4,0,1,5,22,0
409,Thomas Strakosha,GK,Albania,28,1995,3.0,0,0,0,0,0,0,0,,0,0,0,0,0,0,1,0
410,Dávid Strelec,FW,Slovakia,22,2001,2.0,0,0,0,0,0,0,0,,0,2,0,2,0,0,0,0
411,Callum Styles,MF,Hungary,23,2000,0.7,0,0,0,0,0,0,1,0.0,1,0,0,0,1,1,1,0
412,Luka Sučić,"FW,MF",Croatia,21,2002,1.6,0,0,0,0,0,0,0,,0,4,0,4,1,1,1,0
413,Heorhiy Sudakov,MF,Ukraine,21,2002,2.9,3,1,2,1,0,3,4,75.0,1,4,1,3,0,3,1,0
414,Pavel Šulc,MF,Czechia,23,2000,0.9,1,1,1,0,0,1,2,50.0,1,1,1,0,1,2,2,0
415,Tomáš Suslov,"FW,MF",Slovakia,21,2002,1.4,4,1,1,3,0,1,4,25.0,3,4,0,4,1,5,0,0
416,Josip Šutalo,DF,Croatia,23,2000,3.0,5,3,5,0,0,2,3,66.7,1,6,5,1,13,18,7,1
417,Oleksandr Svatok,DF,Ukraine,29,1994,0.9,0,0,0,0,0,0,0,,0,2,1,1,3,3,2,0
418,Karol Świderski,FW,Poland,27,1997,1.0,0,0,0,0,0,0,0,,0,0,0,0,0,0,0,0
419,Serhiy Sydorchuk,MF,Ukraine,32,1991,0.1,0,0,0,0,0,0,0,,0,0,0,0,0,0,0,0
420,Attila Szalai,DF,Hungary,26,1998,1.1,2,2,2,0,0,1,3,33.3,2,0,0,0,2,4,2,0
421,Wojciech Szczęsny,GK,Poland,33,1990,2.0,0,0,0,0,0,0,1,0.0,1,1,0,1,0,0,2,0
422,Dominik Szoboszlai,MF,Hungary,23,2000,3.0,2,0,0,1,1,0,0,,0,4,1,3,2,4,6,0
423,Sebastian Szymański,MF,Poland,24,1999,1.2,7,2,5,2,0,5,10,50.0,5,3,1,2,3,10,1,0
424,Dušan Tadić,MF,Serbia,35,1988,1.7,2,2,0,1,1,0,0,,0,1,0,1,1,3,3,0
425,Jonathan Tah,DF,Germany,27,1996,3.5,2,1,1,1,0,1,1,100.0,0,2,1,1,4,6,11,0
426,Maksym Talovierov,MF,Ukraine,23,2000,0.0,0,0,0,0,0,0,0,,0,0,0,0,0,0,0,0
427,Aurélien Tchouaméni,MF,France,24,2000,5.2,9,7,3,4,2,3,8,37.5,5,2,1,1,5,14,10,1
428,Arthur Theate,DF,Belgium,23,2000,2.8,2,2,0,0,2,0,1,0.0,1,5,0,5,2,4,9,0
429,Marcus Thuram,FW,France,26,1997,2.9,2,2,0,0,2,0,0,,0,6,2,4,0,2,2,0
430,Youri Tielemans,MF,Belgium,26,1997,1.6,2,2,1,1,0,0,1,0.0,1,3,1,2,1,3,0,0
431,Kieran Tierney,DF,Scotland,26,1997,1.5,2,1,2,0,0,1,3,33.3,2,1,1,0,0,2,4,0
432,Ivan Toney,FW,England,27,1996,0.5,1,1,0,1,0,0,0,,0,0,0,0,0,1,1,0
433,Ferrán Torres,"FW,MF",Spain,23,2000,1.7,0,0,0,0,0,0,1,0.0,1,3,0,3,1,1,1,0
434,Cenk Tosun,FW,Türkiye,32,1991,0.3,0,0,0,0,0,0,0,,0,0,0,0,0,0,0,0
435,Gernot Trauner,DF,Austria,31,1992,1.0,2,1,2,0,0,0,1,0.0,1,2,2,0,1,3,1,0
436,Kieran Trippier,DF,England,33,1990,5.0,7,4,3,3,1,3,8,37.5,5,3,1,2,5,12,8,0
437,Leandro Trossard,FW,Belgium,29,1994,1.9,2,1,1,1,0,1,2,50.0,1,2,0,2,0,2,0,0
438,Anatolii Trubin,GK,Ukraine,22,2001,2.0,0,0,0,0,0,0,0,,0,0,0,0,0,0,1,0
439,Heorhii Tsitaishvili,"DF,MF",Georgia,23,2000,2.1,5,4,5,0,0,3,3,100.0,0,0,0,0,0,5,3,1
440,Viktor Tsyhankov,FW,Ukraine,26,1997,0.7,0,0,0,0,0,0,1,0.0,1,1,0,1,0,0,1,0
441,Ľubomír Tupta,MF,Slovakia,25,1998,0.1,0,0,0,0,0,0,0,,0,0,0,0,0,0,0,0
442,Oleksandr Tymchyk,DF,Ukraine,27,1997,2.2,10,4,5,5,0,6,12,50.0,6,2,0,2,3,13,6,0
443,Deniz Undav,MF,Germany,27,1996,0.1,1,1,0,0,1,1,1,100.0,0,0,0,0,0,1,0,0
444,Dayot Upamecano,DF,France,25,1998,6.3,9,7,6,3,0,5,6,83.3,1,3,1,2,6,15,24,0
445,Kacper Urbanski,"FW,MF",Poland,19,2004,1.6,2,1,2,0,0,1,3,33.3,2,2,0,2,1,3,2,0
446,Virgil van Dijk,DF,Netherlands,32,1991,6.0,4,2,4,0,0,1,1,100.0,0,5,4,1,2,6,36,1
447,Vladyslav Vanat,FW,Ukraine,22,2002,0.2,0,0,0,0,0,0,0,,0,0,0,0,0,0,0,0
448,Barnabás Varga,FW,Hungary,30,1994,2.8,4,1,1,2,1,2,2,100.0,0,5,1,4,1,5,7,0
449,Ruben Vargas,"MF,FW",Switzerland,25,1998,3.4,6,5,3,2,1,2,4,50.0,2,5,0,5,2,8,4,1
450,Denis Vavro,DF,Slovakia,27,1996,4.3,2,1,2,0,0,2,4,50.0,2,6,5,1,2,4,18,0
451,Joey Veerman,MF,Netherlands,25,1998,2.3,3,1,1,1,1,3,7,42.9,4,4,1,3,1,4,1,0
452,Miloš Veljković,DF,Serbia,28,1995,3.0,2,0,2,0,0,2,2,100.0,0,0,0,0,0,2,6,0
453,Micky van de Ven,DF,Netherlands,22,2001,0.8,1,1,1,0,0,1,2,50.0,1,2,1,1,0,1,5,0
454,Benjamin Verbič,MF,Slovenia,30,1993,0.8,3,2,1,2,0,1,3,33.3,2,0,0,0,1,4,2,0
455,Bart Verbruggen,GK,Netherlands,21,2002,6.0,1,1,1,0,0,0,0,,0,0,0,0,0,1,4,0
456,Jan Vertonghen,DF,Belgium,36,1987,3.0,4,2,1,3,0,0,0,,0,2,1,1,0,4,10,0
457,Jannik Vestergaard,DF,Denmark,31,1992,4.0,3,3,3,0,0,3,3,100.0,0,3,2,1,4,7,12,0
458,Žan Vipotnik,FW,Slovenia,21,2002,0.2,0,0,0,0,0,0,1,0.0,1,0,0,0,0,0,1,0
459,Vitinha,MF,Portugal,23,2000,4.0,3,3,0,2,1,1,3,33.3,2,3,1,2,2,5,3,0
460,Daniel Vivian,DF,Spain,24,1999,1.4,2,2,2,0,0,2,3,66.7,1,1,1,0,1,3,10,0
461,Dušan Vlahović,"MF,FW",Serbia,24,2000,2.0,0,0,0,0,0,0,1,0.0,1,0,0,0,1,1,0,0
462,Stefan de Vrij,DF,Netherlands,31,1992,6.0,12,7,7,4,1,8,10,80.0,2,6,2,4,2,14,20,0
463,Kyle Walker,DF,England,33,1990,7.7,7,4,3,3,1,4,7,57.1,3,7,1,6,6,13,7,0
464,Ollie Watkins,FW,England,28,1995,0.7,0,0,0,0,0,0,0,,0,0,0,0,1,1,0,0
465,Wout Weghorst,FW,Netherlands,31,1992,1.5,2,1,1,1,0,1,1,100.0,0,2,1,1,0,2,2,0
466,Andreas Weimann,FW,Austria,32,1991,0.0,0,0,0,0,0,0,0,,0,0,0,0,0,0,0,0
467,Silvan Widmer,DF,Switzerland,30,1993,3.3,2,1,1,1,0,1,1,100.0,0,3,1,2,2,4,11,0
468,Georginio Wijnaldum,MF,Netherlands,33,1990,0.8,0,0,0,0,0,0,0,,0,0,0,0,0,0,0,0
469,Nico Williams,FW,Spain,21,2002,5.5,3,2,0,1,2,1,5,20.0,4,5,0,5,0,3,1,0
470,Patrick Wimmer,"FW,MF",Austria,22,2001,1.5,2,2,0,2,0,1,5,20.0,4,4,0,4,0,2,1,0
471,Jonas Wind,FW,Denmark,24,1999,2.1,0,0,0,0,0,0,1,0.0,1,1,0,1,0,0,1,0
472,Florian Wirtz,"FW,MF",Germany,20,2003,3.1,3,3,0,2,1,1,3,33.3,2,3,0,3,1,4,1,0
473,Maximilian Wöber,DF,Austria,25,1998,1.9,4,3,2,2,0,2,3,66.7,1,3,2,1,4,8,6,0
474,Granit Xhaka,MF,Switzerland,31,1992,5.3,8,5,3,4,1,4,6,66.7,2,5,4,1,1,9,15,0
475,Lamine Yamal,FW,Spain,16,2007,5.6,11,6,5,4,2,5,9,55.6,4,6,0,6,3,14,2,0
476,Roman Yaremchuk,FW,Ukraine,28,1995,1.3,0,0,0,0,0,0,2,0.0,2,1,1,0,0,0,1,0
477,Andriy Yarmolenko,"FW,MF",Ukraine,34,1989,1.2,2,2,0,1,1,1,3,33.3,2,1,0,1,1,3,0,0
478,Yusuf Yazıcı,"MF,FW",Türkiye,27,1997,0.6,1,1,0,0,1,1,3,33.3,2,0,0,0,0,1,0,0
479,Kenan Yıldız,"FW,MF",Türkiye,18,2005,3.8,3,2,2,1,0,2,2,100.0,0,4,0,4,0,3,2,0
480,Okay Yokuşlu,"MF,DF",Türkiye,29,1994,0.6,2,1,1,1,0,0,1,0.0,1,2,0,2,2,4,4,0
481,İsmail Yüksek,MF,Türkiye,25,1999,1.7,6,2,2,3,1,3,5,60.0,2,2,1,1,1,7,4,0
482,Illia Zabarnyi,DF,Ukraine,21,2002,3.0,4,3,4,0,0,1,2,50.0,1,2,2,0,1,5,7,0
483,Mattia Zaccagni,"MF,FW",Italy,28,1995,0.9,1,0,0,1,0,0,1,0.0,1,1,0,1,1,2,0,0
484,Denis Zakaria,MF,Switzerland,27,1996,0.3,0,0,0,0,0,0,0,,0,1,0,1,0,0,1,0
485,Nicola Zalewski,DF,Poland,22,2002,2.7,3,1,2,1,0,1,5,20.0,4,2,1,1,2,5,4,0
486,Piotr Zieliński,MF,Poland,29,1994,2.8,0,0,0,0,0,0,2,0.0,2,4,0,4,2,2,3,0
487,Oleksandr Zinchenko,DF,Ukraine,27,1996,2.4,6,5,4,1,1,4,8,50.0,4,4,1,3,1,7,4,0
488,Joshua Zirkzee,"FW,DF",Netherlands,22,2001,0.1,1,1,1,0,0,0,0,,0,0,0,0,0,1,0,0
489,Andrija Živković,DF,Serbia,27,1996,2.7,2,2,2,0,0,1,2,50.0,1,3,0,3,0,2,5,0
490,Budu Zivzivadze,"FW,MF",Georgia,29,1994,0.2,0,0,0,0,0,0,0,,0,0,0,0,0,0,0,0
491,Steven Zuber,MF,Switzerland,32,1991,0.9,0,0,0,0,0,0,1,0.0,1,0,0,0,0,0,0,0
492,Martín Zubimendi,MF,Spain,24,1999,1.6,8,5,3,3,2,4,6,66.7,2,1,1,0,0,8,0,0
493,Oleksandr Zubkov,FW,Ukraine,27,1996,0.3,1,0,1,0,0,0,3,0.0,3,1,0,1,0,1,1,0
